...###
..##.#.####
.##..###..#
##........#
#......#..#
###..###..#
..#..#@...#
.##.##.#.##
.#......##
.#.....##
.#######